A.T.L.=ETL
A.W.S.=AWS
Addhawk=ad-hoc
Ah=
Ahh=
Ahhh=
Amazon-Web-Services=Amazon Web Services
Availability-Zones=Availability Zones
Ayy-Tee-Ell=ETL
C.I.C.D.=CICD
C.S.V.=CSV
Cally=Glue
Cloud-Nine=Cloud Nine
CloudWatch-logs=CloudWatch logs
Data-dictionaries=data dictionaries
Donna=data
E.C.R.=ECR
E.C.S.=ECS
E.M.R.=EMR
Eee-Emm-Arrr=EMR
Eee-See-Arr=ECR
Eee-See-Ess=ECS
Eee-See-Two-Container-Registry=EC2 Container Registry
Eee-See-Two-Container-Service=EC2 Container Service
Eee-See-Two=EC2
Eeeseetwo=EC2
Elastic-Block-Store=Elastic Block Store
Elastic-Compute-Cloud=Elastic Compute Cloud
Elastic-Container-Registry=Elastic Container Registry
Elastic-Container-Service=Elastic Container Service
Ess-Three=S3
Essthree=S3
E.T.L.=ETL
Exemell=XML
Gonna=going to
H.T.T.P.=HTTP
H.T.T.P.S.=HTTPS
I'd=I'd
I'll=I'll
I'm=I'm
I've=I've
I.A.M.=IAM
I.D.E.=IDE
I.O.T.=IOT
I=I
J.D.B.C.=JDBC
Jason=JSON
Kanaesis=Kinesis
Kanasis=Kinesis
Lambda=Lambda
MariaDeeBee=MariaDB
Postgress-que-ell=PostgreSQL
Postgress=PostgreSQL
Public-Sector-Team=Public Sector Team
Public-Sector=Public Sector
R.D.S.=RDS
S.Q.S.=SQS
See-Aye-See-Dee=CICD
See-ess-vee=CSV
Simple-Storage-Service=Simple Storage Service
Solutions-Architect=Solutions Architect
Spark=Spark
Sydney=Sydney
Umm=
Ummm=
X.M.L.=XML
X.M.L.=XML